2 1 1 1 1 7 1 1 1 7 1 1 1 1 1 10 
5 2 1 1 1 1 1 1 1 1 1 1 1 1 10 6
5 5 0 0 0 0 0 0 0 0 0 0 0 0 6 6
5 5 0 0 0 0 0 0 0 0 0 0 0 0 6 6
5 5 0 0 0 0 0 0 0 0 0 0 0 0 6 6
5 11 4 4 4 4 4 4 4 4 4 4 4 0 6 6
5 5 0 0 0 0 0 0 0 0 0 0 0 0 6 6
5 5 0 0 0 0 0 0 0 0 0 0 0 0 6 6
5 5 0 0 0 0 0 0 0 0 0 0 0 0 6 6
5 5 0 0 0 0 0 0 0 0 0 0 0 0 6 6
5 8 3 3 3 3 3 3 3 3 3 3 3 3 9 6
8 3 3 3 3 3 3 3 3 3 3 3 3 3 3 9